中国经济网北京12月13日讯近日，执行信息公开网显示，北京居然之家投资控股集团有限公司新增被执行人信息，案号（2021）内0102执5250号，执行标的596.23万元，立案日期为2021年12月8日，执行法院为呼和浩特市新城区人民法院。	中国经济网北京12月13日讯近日，执行信息公开网显示，北京居然之家投资控股集团有限公司新增被执行人信息，案号（2021）内0102执5250号，执行标的596.23万元，立案日期为2021年12月8日，执行法院为呼和浩特市新城区人民法院。
运城频道讯2017年1月6日，运城市委政法委矛盾纠纷排查调处办公室副主任李铁军，带领盐湖区委政法委矛盾纠纷排查调处办公室主任王春娟一行4人，深入盐湖区法院就诉调对接工作进行司法调研，副院长原菲娜参加调研活动。	运城频道讯2017年1月6日，运城市委政法委矛盾纠纷排查调处办公室副主任李铁军，带领盐湖区委政法委矛盾纠纷排查调处办公室主任王春娟一行4人，深入盐湖区法院就诉调对接工作进行司法调研，副院长原菲娜参加调研活动。
）温州市中级人民法院一审、浙江省高级人民法院二审的被告人戴晓满故意杀人一案，近日经最高人民法院依法核准死刑。温州市中级人民法院收到最高人民法院刑事裁定书后向戴晓满进行了宣告，并于2019年12月10日下午遵照最高人民法院院长签发的执行死刑命令，对戴晓满执行了死刑。	）温州市中级人民法院一审、浙江省高级人民法院二审的被告人戴晓满故意杀人一案，近日经最高人民法院依法核准死刑。温州市中级人民法院收到最高人民法院刑事裁定书后向戴晓满进行了宣告，并于2019年12月10日下午遵照最高人民法院院长签发的执行死刑命令，对戴晓满执行了死刑。
为推动领导干部违规插手干预工程建设和矿产开发突出问题专项整治深入开展，发挥典型案例警示震慑作用，日前，我省7市先后通报一批领导干部违规插手干预工程建设和矿产开发突出问题典型案例。4.甘泉县人民法院原党组书记、院长刘志秀违规插手干预工程建设问题。	为推动领导干部违规插手干预工程建设和矿产开发突出问题专项整治深入开展，发挥典型案例警示震慑作用，日前，我省7市先后通报一批领导干部违规插手干预工程建设和矿产开发突出问题典型案例。4.甘泉县人民法院原党组书记、院长刘志秀违规插手干预工程建设问题。
幼儿园花了23万元，购买两辆新校车接送娃娃，没想到买来的校车开了不到两周，出现各种问题。其中一辆校车还出现刹车问题，幼儿园校长只得花高价租车接送娃娃。为此，幼儿园多次找经销商和厂家，要求退车或者更换新车，却遭到拒绝。无奈之下，幼儿园将经销商告上法庭，要求退车退款，并赔偿各种经济损失共计72万余元。近日，昆明市西山法院审理后，认定两辆校车均是不合格产品，存在质量问题，判决退车退款，并赔偿损失6万余元。目前，幼儿园已向昆明中院提起上诉。	幼儿园花了23万元，购买两辆新校车接送娃娃，没想到买来的校车开了不到两周，出现各种问题。其中一辆校车还出现刹车问题，幼儿园校长只得花高价租车接送娃娃。为此，幼儿园多次找经销商和厂家，要求退车或者更换新车，却遭到拒绝。无奈之下，幼儿园将经销商告上法庭，要求退车退款，并赔偿各种经济损失共计72万余元。近日，昆明市西山法院审理后，认定两辆校车均是不合格产品，存在质量问题，判决退车退款，并赔偿损失6万余元。目前，幼儿园已向昆明中院提起上诉。
（原标题：冒充监狱管理局民警以低价办卡为幌诈骗9人4000多万）法制晚报·看法新闻买来警服，私刻公章，冒充北京市监狱管理局的民警，女子田某谎称可以从单位低价购买到中石化、中移动等储值卡卖，诈骗王某等9名被害人货款共计4000余万元。今天上午，涉嫌诈骗罪的田某在北京二中院受审，在法庭上，田某表示认罪，并承认自己确实用被害人的钱买了宝马车、商品房、手表和20多个名牌包。该案未当庭宣判。	（原标题：冒充监狱管理局民警以低价办卡为幌诈骗9人4000多万）法制晚报·看法新闻买来警服，私刻公章，冒充北京市监狱管理局的民警，女子田某谎称可以从单位低价购买到中石化、中移动等储值卡卖，诈骗王某等9名被害人货款共计4000余万元。今天上午，涉嫌诈骗罪的田某在北京二中院受审，在法庭上，田某表示认罪，并承认自己确实用被害人的钱买了宝马车、商品房、手表和20多个名牌包。该案未当庭宣判。
恒大地产欠下2万亿元的债务被宣扬的满城风雨，有传言恒大会就此倒下，大家怎么看呢？认为恒大的主要原因还是在于经营不善的同时盲目扩大，才会导致欠下巨额债务。只是，巨额债务的事情还未告一段落，欠供应商的2000亿商票又紧随其后。	恒大地产欠下2万亿元的债务被宣扬的满城风雨，有传言恒大会就此倒下，大家怎么看呢？认为恒大的主要原因还是在于经营不善的同时盲目扩大，才会导致欠下巨额债务。只是，巨额债务的事情还未告一段落，欠供应商的2000亿商票又紧随其后。
星岛消息：2017年4月11日上午，在郑州市第十四届人民代表大会第五次会议上，郑州市中级人民法院院长于东辉作工作报告。郑州中院官方微信公号同时刊发小编解读报告中那些大案要案。其中显示，河南人民广播电台原台长李新全受贿案。郑州中院披露案情如下：2008年12月底至2014年春节期间，被告人李新全利用担任河南人民广播电台台长的职务便利，先后多次收受河南弘锦文化传播有限公司、河南新维思广告有限公司等公司负责人财物共计798.05万元，为其公司取得广播电台广告代理权提供帮助。法院依法以受贿罪判处其有期徒刑十一年六个月，剥夺政治权利二年，并处罚金人民币100万元。	星岛消息：2017年4月11日上午，在郑州市第十四届人民代表大会第五次会议上，郑州市中级人民法院院长于东辉作工作报告。郑州中院官方微信公号同时刊发小编解读报告中那些大案要案。其中显示，河南人民广播电台原台长李新全受贿案。郑州中院披露案情如下：2008年12月底至2014年春节期间，被告人李新全利用担任河南人民广播电台台长的职务便利，先后多次收受河南弘锦文化传播有限公司、河南新维思广告有限公司等公司负责人财物共计798.05万元，为其公司取得广播电台广告代理权提供帮助。法院依法以受贿罪判处其有期徒刑十一年六个月，剥夺政治权利二年，并处罚金人民币100万元。
原标题：广州白云钟落潭有刺激性气体地铁一度不停站通过！环境局称正排查11月21日晚，南都记者接到报料，广州市白云区钟落潭镇有刺激性气体，也有网友反映，广州地铁十四号线往嘉禾望岗方向，竹料和太和区间，车厢内有刺激性气体。当晚，南都记者从广州生态环境局获悉，已对刺激性气体来源进行排查，排查结果会第一时间向外界通报。当晚22时20分许，据广州地铁消息，目前钟落潭站已无刺激性气味，恢复正常运营。	原标题：广州白云钟落潭有刺激性气体地铁一度不停站通过！环境局称正排查11月21日晚，南都记者接到报料，广州市白云区钟落潭镇有刺激性气体，也有网友反映，广州地铁十四号线往嘉禾望岗方向，竹料和太和区间，车厢内有刺激性气体。当晚，南都记者从广州生态环境局获悉，已对刺激性气体来源进行排查，排查结果会第一时间向外界通报。当晚22时20分许，据广州地铁消息，目前钟落潭站已无刺激性气味，恢复正常运营。
消息近日，上海一起巨额非法吸收公众存款案曝光，国阳资产、国阳以及国诚公司非法吸收投资人资金近16亿元，团伙共计10人获刑，其中主犯被判有期徒刑7年，并处罚金人民币30万元，公布了该案的相关细节。上海市虹口区人民法院认为，被告人温某等10人结伙或与他人结伙，违反国家金融管理法律规定，非法吸收公众存款，扰乱金融秩序，其行为均已构成非法吸收公众存款罪。	消息近日，上海一起巨额非法吸收公众存款案曝光，国阳资产、国阳以及国诚公司非法吸收投资人资金近16亿元，团伙共计10人获刑，其中主犯被判有期徒刑7年，并处罚金人民币30万元，公布了该案的相关细节。上海市虹口区人民法院认为，被告人温某等10人结伙或与他人结伙，违反国家金融管理法律规定，非法吸收公众存款，扰乱金融秩序，其行为均已构成非法吸收公众存款罪。
本报讯(记者乔军吴淞)，昨天，记者在最高人民法院门口碰到广东省肇庆市四会市的广东白云清洁科技有限公司的法人代表王晓明，工程项目负责人江兆焘两人，他们来北京实名举报四会市人民法院违反级别管辖，违规判决。	本报讯(记者乔军吴淞)，昨天，记者在最高人民法院门口碰到广东省肇庆市四会市的广东白云清洁科技有限公司的法人代表王晓明，工程项目负责人江兆焘两人，他们来北京实名举报四会市人民法院违反级别管辖，违规判决。
云南一对90后夫妻在行车途中，妻子与丈夫发生争吵后丢下孩子，赌气跳车身亡。丈夫因犯过失致人死亡罪，判处有期徒刑三年，缓刑四年。	云南一对90后夫妻在行车途中，妻子与丈夫发生争吵后丢下孩子，赌气跳车身亡。丈夫因犯过失致人死亡罪，判处有期徒刑三年，缓刑四年。
江苏一名男子合同官司败诉后，在网上实名举报法官枉法，被控犯寻衅滋事罪遭判一年。今年9月，他出狱后仍在继续举报。12月15日，记者采访获悉，他败诉的该民事官司申请检方监督已获受理，目前正在进一步调查处理中。	江苏一名男子合同官司败诉后，在网上实名举报法官枉法，被控犯寻衅滋事罪遭判一年。今年9月，他出狱后仍在继续举报。12月15日，记者采访获悉，他败诉的该民事官司申请检方监督已获受理，目前正在进一步调查处理中。
12月17日，据广东陆丰市本地资讯公众号“陆丰一线”消息，12月16日，汕尾、陆丰两级法院联合在陆丰东海镇体育广场召开宣判大会，对杀人、抢劫、涉毒的12名犯罪分子公开宣判，其中10人经最高法死刑复核核准，宣判后押赴刑场，立即执行。	12月17日，据广东陆丰市本地资讯公众号“陆丰一线”消息，12月16日，汕尾、陆丰两级法院联合在陆丰东海镇体育广场召开宣判大会，对杀人、抢劫、涉毒的12名犯罪分子公开宣判，其中10人经最高法死刑复核核准，宣判后押赴刑场，立即执行。
原标题：广西罗城两屯群众持械斗殴致3死12伤，51人获刑广西罗城两屯群众持械斗殴致3死12伤，51人获刑2021年9月28日上午，罗城仫佬族自治县人民法院依法对该县龙岸镇榕山村水浐屯、地催屯群众聚众斗殴案中的51名被告人进行一审公开宣判。本案中参与组织或者策划或者直接致人死亡、重伤的刘某光等9人，因涉嫌犯故意杀人罪、故意伤害罪，由河池市中级人民法院另案审理，目前该案正在进一步办理中。	原标题：广西罗城两屯群众持械斗殴致3死12伤，51人获刑广西罗城两屯群众持械斗殴致3死12伤，51人获刑2021年9月28日上午，罗城仫佬族自治县人民法院依法对该县龙岸镇榕山村水浐屯、地催屯群众聚众斗殴案中的51名被告人进行一审公开宣判。本案中参与组织或者策划或者直接致人死亡、重伤的刘某光等9人，因涉嫌犯故意杀人罪、故意伤害罪，由河池市中级人民法院另案审理，目前该案正在进一步办理中。
关注广州保利蹊跷介入大塱村旧改之困：拆迁遇阻本报记者/余燕明/广州报道元旦刚过，罗大爷在广州黄埔萝岗大塱村的第二栋房子再次被拆，他和老伴不得不住进了村里的祠堂。目前，大塱村正在进行旧村改造，罗大爷是拒绝在拆迁补偿协议上签字的村民之一。大塱村所属的萝岗社区经济联合社（以下简称“萝岗经济联社”）主导了拆迁工作，罗大爷等30多户村民不愿意签订拆迁补偿协议后，他们的房子被萝岗街道城管执法队认定为“违法建设”，并进行拆除。	关注广州保利蹊跷介入大塱村旧改之困：拆迁遇阻本报记者/余燕明/广州报道元旦刚过，罗大爷在广州黄埔萝岗大塱村的第二栋房子再次被拆，他和老伴不得不住进了村里的祠堂。目前，大塱村正在进行旧村改造，罗大爷是拒绝在拆迁补偿协议上签字的村民之一。大塱村所属的萝岗社区经济联合社（以下简称“萝岗经济联社”）主导了拆迁工作，罗大爷等30多户村民不愿意签订拆迁补偿协议后，他们的房子被萝岗街道城管执法队认定为“违法建设”，并进行拆除。
据悉，合生中央城是黄埔火村旧改项目，规划配建2所中小学、4所幼儿园、5所托儿所。销售总监童先生表示，目前学校主体建筑已基本完成，预计今年7月底完成建设并移交教育局。近日，广州市民彭女士为此事操碎了心。两年前，彭女士在黄埔区合生中央城置业，当时销售人员向她承诺凭借购房合同即可入读配套学校，后来才得知政策要求必须人户一致。如今距离2022年小学报名仅剩不到两个月，彭女士因还未收楼，孩子无法入读配套学校。对此，合生中央城回应称从未承诺凭购房合同入学，目前正在和相关部门沟通协商。	据悉，合生中央城是黄埔火村旧改项目，规划配建2所中小学、4所幼儿园、5所托儿所。销售总监童先生表示，目前学校主体建筑已基本完成，预计今年7月底完成建设并移交教育局。近日，广州市民彭女士为此事操碎了心。两年前，彭女士在黄埔区合生中央城置业，当时销售人员向她承诺凭借购房合同即可入读配套学校，后来才得知政策要求必须人户一致。如今距离2022年小学报名仅剩不到两个月，彭女士因还未收楼，孩子无法入读配套学校。对此，合生中央城回应称从未承诺凭购房合同入学，目前正在和相关部门沟通协商。
广州某人才服务有限公司广州分公司派驻到广州增城区一通信营服点的多名员工向广东“工人在线”平台报料，反映其因申请劳动仲裁而遭到用工单位管理人员打压部分维权职工许接英/摄南方工报讯（全媒体记者许接英）日前，广州某人才服务有限公司广州分公司（以下简称“广州某人才服务公司”）派驻到广州增城区一通信营服点的多名员工向广东“工人在线”平台报料，反映其因申请劳动仲裁而遭到用工单位管理人员打压。10月21日，记者前往增城区进行了采访。	广州某人才服务有限公司广州分公司派驻到广州增城区一通信营服点的多名员工向广东“工人在线”平台报料，反映其因申请劳动仲裁而遭到用工单位管理人员打压部分维权职工许接英/摄南方工报讯（全媒体记者许接英）日前，广州某人才服务有限公司广州分公司（以下简称“广州某人才服务公司”）派驻到广州增城区一通信营服点的多名员工向广东“工人在线”平台报料，反映其因申请劳动仲裁而遭到用工单位管理人员打压。10月21日，记者前往增城区进行了采访。
扫黑除恶风暴席卷阳江，老百姓拍手称快。广东省阳江市桂顺船舶租赁有限公司实业家黄全杯自然是拍手拍得最起劲的人。数十年来，黄全杯父子参与了珠海市桂山岛一湾填海、澳门三桥、港珠澳大桥、珠海市横琴岛开发、广东华夏阳西电厂等国家与地方的重大工程项目建设，并承接这些重大工程项目的筑桥清淤、水路运输、船舶租赁等部份工程的业务，在业务履行实施中难免受到各种黑恶势力的压榨和干扰，现在风清气正，还不甩开膀子大干一场？	扫黑除恶风暴席卷阳江，老百姓拍手称快。广东省阳江市桂顺船舶租赁有限公司实业家黄全杯自然是拍手拍得最起劲的人。数十年来，黄全杯父子参与了珠海市桂山岛一湾填海、澳门三桥、港珠澳大桥、珠海市横琴岛开发、广东华夏阳西电厂等国家与地方的重大工程项目建设，并承接这些重大工程项目的筑桥清淤、水路运输、船舶租赁等部份工程的业务，在业务履行实施中难免受到各种黑恶势力的压榨和干扰，现在风清气正，还不甩开膀子大干一场？
对此，全国人大代表黄细花建议，取消生育三孩及以上的处罚政策，减轻育儿成本。	对此，全国人大代表黄细花建议，取消生育三孩及以上的处罚政策，减轻育儿成本。
